11111111111111111111111111111111
10000000000000000000000000000001
10P00000000000000000010000000001
10000C00000000000000101000000001
10000CC000000CCC0000010000000001
1000000000000CCC0000000000000001
1011000000001CCC0000000000000001
101100000000000000000000E0000001
10000000000000000000000000000001
10000000000000000000000000000001
10000000000000000000000000000001
10000000000000000000000000000001
10000000000000000000000000000001
10000000000000000000000000000001
10000000000000000000000000000001
10000000000000000000000000000001
11111111111111111111111111111111