111111111111111
10P01CC000M0001
1EC00110C000M01
10M0C0C00010001
111111111111111