111111111111111
1E0000000000001
10000000C000001
1000000000000P1
111111111111111