111111111111111
1P000CC00000001
10C00000C000001
1000C00000000E1
111111111111111