111111111111111
1P000CC00001001
10C10000C000001
1000C00000100E1
111111111111111