111111111111111
1P0000000000001
10000000C000001
1000000000000E1
111111111111111