111111111111111
1P001CCE0001001
10C00110C000001
1000C0000010001
111111111111111