111111111111111
10P01CC00001001
1EC00110C000001
1000C0C00010E01
111111111111111