111111111111111
10P010000001001
1E0001100000001
100000000010001
111111111111111