111111111111111
100000100000001
10E0P0100000C01
100000100000001
111111111111111