111111111111111
10P01CC00001001
10C00110C000001
1000C0C00010001
111111111111111