111111111111111
10001CC00001001
1EC00110C000001
1000C0C00010001
111111111111111