111111111111111
10P01CC00001001
1EC00110C000000
1000C0C00010001
111111111111111